1111111111111
1001000O000C1
1V00011111001
1P0011E00U001
1111111111111
