1111111111111
10010000000C1
10N0011111N01
1P0011E000001
1111111111111
