1111111111111
1N010000000C1
1000011111001
1P0N11E000001
1111111111111
