111111111111111111111111111111111111111111111111111111111111
1P00000000000000000000000000000000000000000000000000000000C1
10001000001000000000000000C000000000000000000000000000000001
100011000010011110011111001000010101000010011110010000100001
100010100010100001010000101100110101100010100001010000100001
10001001001010N001010000101011010101010010100N01010000100001
100010001010100N0101111100100001010100101010N001010000100001
100010000110100001010001001000010101000110100001010CC0100001
100010000010011110010000101000010101000010011110001111000001
1C00000000000000000000000000000000000000000000000000000000E1
111111111111111111111111111111111111111111111111111111111111
