1111111111111
1001000P000C1
1000P11111001
1P0011E000P01
1111111111111
